777777777777777777777
713100000070000000007
711100070070040070007
777700070070000070007
704000000070000070007
700000000070077777707
700007777770070000007
700007888810070000007
707001878870070000007
700001888870074000007
777777777777777711177
700000000000000000007
700000000777000000007
700700788888887007007
700077888888888770007
700007888888888700007
700078888888888870007
700788887777788887007
700788887040788887117
740788881000788887137
777777777777777777777